BBBBBBBBBBBBBBBBBBBBBBBBB
BB.B.B.B.B.B.B.B.B.B.B.BB
B.......................B
BB.BBBBBBBBBBBBBBBBBBB.BB
B.......................B
BB.B.................B.BB
B..B.................B..B
BB.B.................B.BB
B.......................B
BB.BBBBBBBBBBBBBBBBBBB.BB
B.......................B
BB.B.B.B.B.B.B.B.B.B.B.BB
BBBBBBBBBBBBBBBBBBBBBBBBB
