BBBBBBBBBBBBBBBBBBBBBBB
B.....................B
BNNNNNNNN.............B
B.......N.............B
B.......NNNNNNN.......B
B.....................B
B.....................B
B.....................B
B.....................B
B.....................B
B.....................B
BBBBBBBBBBBBBBBBBBBBBBB