BBBBBBBBBBBBBBBBBBBBBBBBB
BB.B.B.B.B.B.B.B.B.B.B.BB
B.N.N.N.N.N.N.N.N.N.N.N.B
BB.BBB.BBBBB.BBBBB.BBB.BB
B.N..B..1..B.B..2..B..N.B
BB.B.B.B.B.B.B.B.B.B.B.BB
B.NB..N.N.N.N.N.N.N..BN.B
BB.B.B.B.B.B.B.B.B.B.B.BB
B.N..B..3..B.B..4..B..N.B
BB.BBB.BBBBB.BBBBB.BBB.BB
B.N.N.N.N.N.N.N.N.N.N.N.B
BB.B.B.B.B.B.B.B.B.B.B.BB
BBBBBBBBBBBBBBBBBBBBBBBBB
