BBBBBBBBBBBBBBBBBBBBBBBBBB
B1..NN..NN..NN..NN..NN..2B
B...NN..NN..NN..NN..NN...B
BNNNBN.N.BN.NBN.NBN.NBNNNB
BN.NN.NN.NN.NN.NN.NN.NNNNB
BNNNBN.N.BN.NBN.NBN.NBNNNB
BN.NBN.N.BN.NBN.NBN.NBNNNB
BNNNBN.N.BN.NBN.NBN.NBNNNB
BN.NN.NN.NN.NN.NN.NN.NNNNB
BNNNBN.N.BN.NBN.NBN.NBNNNB
B...NN..NN..NN..NN..NN...B
B3..NN..NN..NN..NN..NN..4B
BBBBBBBBBBBBBBBBBBBBBBBBBB
