BBBBBBBBBBBBBBBBBBBBBBBBBB
B1..NNNNNNNNNNNNNNNNNN..2B
B...NNNNNNNNNNNNNNNNNN...B
BNNNBNNNNBNNNBNNNBNNNBNNNB
BNNNNNNNNNNNNNNNNNNNNNNNNB
BNNNNNNNNNNNNNNNNNNNNNNNNB
BNNNBNNNNBNNNBNNNBNNNBNNNB
BNNNNNNNNNNNNNNNNNNNNNNNNB
BNNNNNNNNNNNNNNNNNNNNNNNNB
BNNNBNNNNBNNNBNNNBNNNBNNNB
B...NNNNNNNNNNNNNNNNNN...B
B3..NNNNNNNNNNNNNNNNNN..4B
BBBBBBBBBBBBBBBBBBBBBBBBBB
