BBBBBBBBBBBBBBBBBBBBBBB
B1...................2B
BNNNNNNNN.............B
B.......N.............B
B.......NNNNNNN.......B
B.....................B
B.....................B
B.....................B
B.....................B
B.....................B
B4...................3B
BBBBBBBBBBBBBBBBBBBBBBB
