....................
....................
....................
............BBBB....
....................
....................
.........BBBBBBB....
...............B....
...............B....
...............B....
...............B....