BBBBBBBBBBBBBBBBBBBBBBBBBB
B1.....N.....N.......N..2B
B...B..N.B...B...B...B...B
B......NNN...N.......N...B
BNNNB....B...B...B...B...B
B...NNNNNN...NNNN.NNNN...B
B...B....BNNNB...B...B...B
B........N....NNN....NNNNB
B...B....B...B...BNNNB...B
BNNNN....N...............B
B...B....B...B...B...B...B
B4..N....NNNN.......NN..3B
BBBBBBBBBBBBBBBBBBBBBBBBBB
