BBBBBBBBBBBBBBBBBBBBBBBBBB
B1..NN..NN..NN..NN..NN..2B
B.B.NNB.NN.BNNB.NN.BNN.B.B
BNBBBNBNBNNNBBNNNBNBNBBBNB
BNBNBNBBBBBNBBNBBBBBNBNBNB
BN.NBN.N.BN.NN.NB.N.NBN.NB
B...BN.B.BNBBBBNB.B.NB...B
BN.NBN.N.BN.NN.NB.N.NBN.NB
BNBNBNBBBBBNBBNBBBBBNBNBNB
BNBBBNBNBNNNBBNNNBNBNBBBNB
B.B.NNB.NN.BNNB.NN.BNN.B.B
B3..NN..NN..NN..NN..NN..4B
BBBBBBBBBBBBBBBBBBBBBBBBBB
